R 768 1068
NO ./textures/sand.xpm
SO ./textures/sand.xpm
WE ./textures/sand.xpm
EA ./textures/stone.xpm
S ./textures/stone.xpm
F 220,100,0
C 225,30,0

1111111111111111
1000000000000001
1000000001100001
1000000001100001
1000000000000001
1011100000000001
1000100000000001
1N00000000000001
1111111111111111
