R 768 1068
NO ./textures/wall_1.xpm
SO ./textures/wall_2.xpm
WE ./textures/wall_3.xpm
EA ./textures/wall_4.xpm
S ./textures/sprite_1.xpm
F 220,100,0
C 225,30,0

11111111111111
10000000010001
101100W0011101
10000000000001
11111011111111
10000000000001
10000000000001
11111111111111
