R 768 1068
NO ./textures/sand.xpm
SO ./textures/stone.xpm
WE ./textures/banner.xpm
EA ./textures/red_brick.xpm
S ./textures/stone.xpm
F 51,51,51
C 102,204,255

1111111111111111
1000000000000001
1000000001100001
1000000001100001
1000000000000001
1011100000000001
1000100000000001
1N00000000000001
1111111111111111
