R 768 1068
NO ./textures/purplestone.xpm
SO ./textures/stone.xpm
WE ./textures/blue.xpm
EA ./textures/red_brick.xpm
S ./textures/mago.xpm
F 51,51,51
C 102,204,255

1111111111111111
1000000000000001
1000000001100001
1000000001100001
1000000000000001
101120000000W001
1000100000000001
1000000000000001
1111111111111111
