R 1024 768
NO ./textures/wall_1.xpm
SO ./textures/wall_2.xpm
WE ./textures/wall_3.xpm
EA ./textures/wall_4.xpm
S ./textures/sprite_1.xpm
F 220,100,0
C 225,30,0

11111111111111
10000000010001
10110000011101
100000N0000001
11111011111111
10000000000001
10000000000001
11111111111111
