R 768 1068
NO ./textures/sand.xpm
SO ./textures/stone.xpm
WE ./textures/red_brick.xpm
EA ./textures/stone.xpm
S ./textures/stone.xpm
F 51,51,51
C 102,204,255

1 1 1 1 1
1 1 0 1 1
1 1 0 1 1
1 1 0 1 1
1 1 0 1 1
1 1 0 1 1
1 1 0 1 1
1 1 0 1 1
1 1 0 1 1
1 1 0 1 1
1 1 0 1 1
1 1 0 1 1
1 1 0 1 1
1 1 N 1 1
1 1 0 1 1
1 1 0 1 1
1 0 0 0 1
1 0 0 0 1
1 1 1 1 1
