R 500 450
NO ./textures/wall_1.xpm
SO ./textures/wall_2.xpm
WE ./textures/wall_3.xpm
EA ./textures/wall_4.xpm
S ./textures/sprite_1.xpm
F 220,100,0
C 225,30,0

1111111
1000001
1020011
1100N11
1111111
