R 1920 1080
NO ./textures/wall_1.xpm
SO ./textures/wall_2.xpm
WE ./textures/wall_3.xpm
EA ./textures/wall_4.xpm
S ./textures/sprite_1.xpm
F 220,100,0
C 225,30,0

1111 1
1234 6
102001
1100N1
111 1110
